1111111111111
1C01CCC0001C1
110D011010001
1PC1110101E01
1111111111111